0000000000000000000000000000000000000000
0000000001111100000000011111000000000000
0000000000000000000000000000000000000000
1111111111111111111111111111111111111111
0101010101010101010101010101010101010101
0101010101010101010101010101010101010101